TACIER 	XC
TCUIVRE	CU
TLAITON	UZ
TALUMIN	AL 
TINOX  	IN
CORNIER	CO
PLAQDIV	PL
TUBE   	TU 
PLAT   	PT
TPERFOR	TP 	  
ROND   	RD
TUBE_CA	TC
TUBE_RD	TD
TUBE_RE	TR
U      	U 
1/4ROND	QR
BARRE  	BA
H      	H 
T      	T 
HEXA   	HX	  
PRO_VA 	VA  	  
TUBE_AI	TA
PD     	PD
